{
	"layers": {
      "TILES_LAYER": {
        "sprite_class": "TilesPlainSprite",
        "tiles": [
          [0, 0, 0, 0, 0, 0, 20, 21, 0, 0, 0, 20],
          [0, 20, 21, 0, 0, 0, 0, 0, 0, 0, 0, 0],
          [0, 0, 0, 0, 0, 20, 21, 0, 0, 0, 24, 0],
          [21, 0, 0, 0, 0, 0, 0, 1, 2, 2, 23, 2],
          [0, 0, 0, 0, 1, 2, 2, 13, 10, 10, 10, 10],
          [6, 6, 6, 6, 15, 10, 10, 10, 10, 10, 10, 10],
          [22, 22, 22, 22, 15, 10, 10, 10, 10, 10, 10, 10]
        ]
      }
	}
}